1111111111
1P00C00001
11C0000011
11C0000011
11C0010011
11C01C0011
11C0010B11
11C00B0011
11C00B0011
11C0000011
11C0000011
11C0000011
100000E001
1111111111
